{
  "width": 40,
  "height": 40,
  "tiles": [
    "########################################",
    "#S.S.S.#..........#....................#",
    "#.###.#.#.#######..#..######.#########..#",
    "#S....#.#.....#...#........#...........#",
    "#####.#.###.###.#.###############.#######",
    "#.....#.....#...#.................#....#",
    "#.###########.#####################.##.#",
    "#......................................#",
    "########################################"
  ]
}
