{
  "mazes": [
    {
      "name": "Test Maze",
      "width": 40,
      "height": 9,
      "tiles": [
        "########################################",
        "#......#..........#..S.S.S.S...........#",
        "#.###.#.#.#######..#..######.#########..#",
        "#.....#.#.....#...#........#...........#",
        "#####.#.###.###.#.###############.#######",
        "#.....#.....#...#.................#....#",
        "#.###########.#####################.##.#",
        "#......................................#",
        "########################################"
      ]
    },
    {
      "name": "Maze 1",
      "width": 60,
      "height": 14,
      "tiles": [
        "############################################################",
        "#S.........#....................#.......................S.#",
        "#.#######.#.#########.##########.###########.##########.#.#",
        "#.......#.#.........#.#........#...........#.#........#.#.#",
        "#######.#.#########.#.#.######.###########.#.#.######.#.#.#",
        "#.......#...........#.#......#.............#.#......#.#.#.#",
        "#.###################.########.#############.########.#.#.#",
        "#S..................#..........................#........#.#",
        "###################.######################.#####.#######.#",
        "#...........#...............................#.............#",
        "#.#########.#.#############################.#.###########.#",
        "#.#.........#.............................#.#...........#.#",
        "#.#.######################################.#.###########.S#",
        "############################################################"
      ]
    },
    {
      "name": "Maze 2",
      "width": 60,
      "height": 14,
      "tiles": [
        "############################################################",
        "#S..........................#..........................#...#",
        "#.##########################.##################.#######.##.#",
        "#.#........#................#..................#.........#.#",
        "#.#.######.#.##############.##################.#########.#.#",
        "#S#......#.#.#............#.#..................#.........#.#",
        "#.########.#.#.##########.#.###################.#########.#.#",
        "#..........#.#..........#...#.................#..........#S#",
        "############.############.###.#################.###########",
        "#..........#..............#...#.........#.................#",
        "#.########.################.###.#######.#.#################",
        "#.#........#................#...#.......#.................#",
        "#.#.########################################.#############S#",
        "############################################################"
      ]
    },
    {
      "name": "Maze 3",
      "width": 60,
      "height": 14,
      "tiles": [
        "############################################################",
        "#S........#.......#.........................................#",
        "#.#######.#.#####.#####################################.###.#",
        "#.#.....#.#.....#.#.....................................#...#",
        "#.#.###.#.#####.#.#.###################################.###.#",
        "#.#...#.#.......#...#...............#...................#...#",
        "#.###.#.#########.###.#############.#.###################.###",
        "#.....#S..........#...#.............#.................#.....#",
        "#################.#.###.#############.###############.#####.#",
        "#.................#.....#.............#...............#.....#",
        "#.#######################.#############.###############.#####",
        "#.#S........................#.................#.............#",
        "#.######################################################.###.#",
        "############################################################"
      ]
    },
    {
      "name": "Maze 4",
      "width": 60,
      "height": 14,
      "tiles": [
        "############################################################",
        "#...#..............................#.......................#",
        "#.#.#.############################.#####################.#.#",
        "#.#.#S#..........#.................#...................#.#.#",
        "#.#.#.#.########.#.###############.#.#################.#.#.#",
        "#.#...#.#........#...#.............#.#.................#.#.#",
        "#.#####.#.##########.#.#############.#.#################.#.#",
        "#S......#............#.............#.#.#...............#.#.#",
        "########################################.#############.#.#.#",
        "#...............................#......#.............#.#.#.#",
        "#.#############################.#.######.###########.#.#.#.#",
        "#.#.............................#........#...........#...#S#",
        "#.#.#############################################.#########.#",
        "############################################################"
      ]
    },
    {
      "name": "Maze 5",
      "width": 60,
      "height": 14,
      "tiles": [
        "############################################################",
        "#.....................#.......#.............#.............S#",
        "#.###################.#######.#.###########.#.###########.#",
        "#.#.................#.........#.#...........#.#...........#",
        "#.#.###############.###########.#.###########.#.###########",
        "#S#.#...............#...........#...........#.............#",
        "#.#.#.#############.#.###########.#########.###############",
        "#.#.#.#.............#.#...........#.........#.............#",
        "#.#.#.#.#############.#.###########.#########.###########.#",
        "#.#...#S..........#...#.............#.........#...........#",
        "#.###############.#.###################.#######.###########",
        "#.................#.......................#...............#",
        "#.###########################################.#############.#",
        "############################################################"
      ]
    }
  ]
}
